111111111111111111111111111111111
100000000000000000000001111111111
1N0000011111111111111111111111111111
10001111111111111111111111111111111
1001111111111111111111111111111111
1001111111111111111111111111111111
111111111111111111111111111111111