111111111111111111111111111111
11111111111111111111111111111111
100000000111111111111111111111111
100N0000011111111
11111111111111111111111