NO ./textures/wall_1.xpm
SO ./textures/wall_1.xpm
WE ./textures/wall_1.xpm
EA ./textures/wall_1.xpm
C 225,30,0
F 220,100,0

111111111111111111111111
10011111111111111111111
11011111111      11N111111
11111111111111111d11111
1111              111111
111111111000000000001111


