NO ./textures/wall_1.xpm
SO ./textures/wall_1.xpm
WE ./textures/wall_1.xpm
EA ./textures/wall_1.xpm
C 225,30,0
F 220,100,0

1111111111111111111111111111
1000001100010110000000000001
1000001100010110000000000001
1000001100010110000000000001
1000001111111110000000000001
10000011001100000111011111111
11111111111111101100000001001
11110111111 11011101000010001
11000000110101011100010010001
10000000000000001100N00000001
10000000000000001100000010001
10000000000000001101010010001
11000001110101011111010110001
11110111111101011101111010001
11111111111111111111111111111