NO ./textures/wall_1.xpm
SO ./textures/wall_1.xpm
WE ./textures/wall_1.xpm
EA ./textures/wall_1.xpm
C 225,30,0
F 220,100,0

111111111111
100010000011
100000000001
10000N000101
100000000001
100000000001
111111111111