NO ./textures/wall_1.xpm
SO ./textures/wall_1.xpm
WE ./textures/wall_1.xpm
EA ./textures/wall_1.xpm
C 225,30,0
F 220,100,0

11111111111
100000000111
100N00000111
111111111111