NO ./textures/wall_1.xpm
SO ./textures/wall_1.xpm
WE ./textures/wall_1.xpm
EA ./textures/wall_1.xpm
F 220,100,0
C 225,30,0

111111111111111111111111111111111
100000000000000000000001111111111
1N0011111111111111111111111111111
101111111111111111111111111111111
101111111111111111111111111111111
101111111111111111111111111111111
111111111111111111111111111111111